10
10
0 1
9 9
O----OO---
--OO-----O
------O---
---O--O---
---O--O--O
O--O-----O
O-----O---
----------
OOO---O---
----------
