10
10
0 1
9 9
O---OOO---
--OO--O--O
-O---O----
-O-O------
---O-OOOOO
---O-----O
---OO-OO--
----O-O---
OOO-O-O-OO
------O---
