0000000000
00x0000000
00x0xxx000
00x0000000
0000000xxx
0000x00000
0000x00000
0000x00xxx
0000000x00
0000000x00
