0000000000
00x0000000
00x0xxx000
00x0000000
0000000000
0000x00000
0000x00000
0000x00000
0000000000
0000000000
